#mapinfo
name: Map1
size: 20x50
lives: 10
money: 600
towers: t1, t2

#waves 
number of waves: 5
10, e1, e1, e1, e1
9, e1, e1, e1, e1, e1, e2
8, e1, e2, e1, e1, e1, e1, e2, e2
7, e2, e2, e1, e1, e1, e2, e2, e1, e1, e1, e2
5, e1, e1, e1, e1, e2, e1, e2, e1, e1, e2, e1, e2

#map
++++++++++++++++++++++++++++RRR+++++++++++++++++++
+++++++++++++++++++++++++++RRR++++++++++++++++++++
++++++++++++++++++++++++++RRR+++++++++++++++++++++
+++++++++++++++++++++++++RRR++++++++++++++++++++++
++++++++++++++++++++++++RRR+++++++++++++++++++++++
+++++++++++++++++++++++RRR+++++++++++0000000000000
00000000000++++++++++++RRR+++++++++++0PPPPPPPPPPPP
PPPPPPPPPP0++++++++++++RRR+++++++++++0P00000000000
000000000P0++++++++++++RRR+++++++++++0P0++++++++++
++++++++0P0+++++++++++RRR++++++++++++0P0++++++++++
++++++++0P0000000000000000000000000000P0++++++++++
++++++++0PPPPPPPPPPPPPPPPPPPPPPPPPPPPPP0++++++++++
++++++++00000000000000000000000000000000++++++++++
++++++++++++++++++RRR+++++++++++++++++++++++++++++
+++++++++++++++++RRR++++++++++++++++++++++++++++++
++++++++++++++++RRR+++++++++++++++++++++++++++++++
+++++++++++++++RRR++++++++++++++++++++++++++++++++
++++++++++++++RRR+++++++++++++++++++++++++++++++++
++++++++++++++RRR+++++++++++++++++++++++++++++++++
++++++++++++++RRR+++++++++++++++++++++++++++++++++