#mapinfo
name: Map2
size: 18x48
lives: 10
money: 1000
towers: t1, t2
path start: 9, 5

#waves 
number of waves: 10
100, e1, e1, e1, e2
90, e1, e1, e2, e1, e1, e2
80, e1, e2, e1, e1, e1, e1, e2, e2
70, e2, e2, e1, e1, e1, e2, e2, e1, e1, e1, e2
60, e1, e1, e1, e1, e2, e1, e2, e1, e1, e2, e1, e2
40, e1, e1, e1, e2, e1
60, e1, e1, e2, e1, e1, e2
50, e1, e2, e1, e1, e1, e1, e2, e2
40, e2, e2, e1, e1, e1, e2, e2, e1, e1, e1, e2
30, e1, e1, e1, e1, e2, e1, e2, e1, e1, e2, e1, e2

#map
MMMMMMMMMM+RRRRR+++++++++++RRR++++++++++++++++++
MMMMMMMMMM++RRRR++++++++++RRR+++++++++++++++++++
MMMMMCCCMMM++RRRR++++++++RRR++++++++++++++++++++
MMMMCCCCCMMM++++RRRR++++RRR+++++++++++++++++++++
MMMMCCCCCMMM++++++RRRRRRRR++++++++++++++++++++++
+++++0P0++++++++++++++RRRR+++000000000++++++++++
+++++0P0+++++++++++++++RRR+++0PPPPPPP0++++++++++
+++++0P0+++++++++++++++RRR+++0P00000P0++++++++++
+++++0P0+++++++++++++RRR+++++0P0+++0P0++++++++++
+++++0P00000000000000000000000P0+++0P0++++++++++
+++++0PPPPPPPPPPPPPPPPPPPPPPPPP0+++0P00000000000
+++++000000000000000000000000000+++0PPPPPPPPPPPP
++++++++++++++++++RRR++++++++++++++0000000000000
+++++++++++++++++RRR+++++++++++++++++RRRR+++++++
++++++++++++++++RRR++++++++++++++++RRRRRRRR+++++
+++++++++++++++RRR+++++++++++++++++++RRRRRRR++++
++++++++++++++RRR++++++++++++++++++++++RRR++++++
++++++++++++++RRR+++++++++++++++++++++++++++++++