#mapinfo
name: Battle of Mag Tuireadh
size: 26x51
lives: 10
money: 1000
towers: t1, t2
path start: 9, 5

#waves 
number of waves: 6
80, e1, e1, e1, e2, e2, e1
80, e2, e1, e2, e1, e1, e2
60, e1, e2, e2, e1, e1, e1, e2, e2
70, e2, e2, e1, e1, e1, e2, e2, e1, e1, e1, e2
20, e1, e1, e1, e1, e2, e1, e2, e1, e1, e2, e1, e2, e2, e1
40, e1, e1, e1, e2, e1, e2, e2, e2, e2, e1, e2, e2, e1


#map
MMMMMMMMMM+RRRRR+++++++++++RRR+++++++++++++++++++++
MMMMMMMMMM++RRRR++++++++++RRR++++++++++++++++++++++
MMMMMCCCMMM++RRRR++++++++RRR+++M+M+M+++++++M+M+M+++
MMMMCCCCCMMM++++RRRR++++RRR++++MMMMM+++++++MMMMM+++
MMMMCCQCCMMM++++++RRRRRRRR++++++MMM+++++++++MMM++++
+++++0P0+++++++++++++RRRRR++++++MMM+M+M+M+M+MMM++++
+++++0P0++++++++++++++RRRR++++++MMMMMMMMMMMMMMM++++
+++++0P0++++++++++++++RRRR++++++MMMMMCCCMMMMMMM++++
+++++0P0+++++++++++++++RRR++++RRMMMMMCQCMMMMMMMRR++
+++++0P0++++++++++++++RRR++++RRRMMMMMCQCMMMMMMMRRR+
+++++0P0++++MM+++++++RRR++++++RRRRRRRWBWRRRRRRRRR++
+++++0P0+++MMMM+++++RRR++++++++++++++WBW+++++++++++
+++++0P0++++++++++++RRR++++++++++++++0P000000++++++
+++++0P000000+++++++RRR++++++++++++++0PPPPPP0++++++
+++++0PPPPPP0+++++++RRR++++++++++++++000000P0++++++
+++++000000P0++++++++RRR++++++++++++++++++0P0++++++
++++++++++0P0++++++++RRR++++++++++++++++++0P0++++++
++++++++++0P00000000WWWW0000000000000000000P0++++++
++++++++++0PPPPPPPPBBBBPPPPPPPPPPPPPPPPPPPPP0++++++
++++++++++00000000WWWW00000000000000000000000++++++
++++++++++++++++++RRR++++++++++++++++++++++++++++++
+++++++++++++++++RRR+++++++++++++++++RRRR++++++++++
++++++++++++++++RRR++++++++++++++++RRRRRRRR++++++++
+++++++++++++++RRR+++++++MM++++++++++RRRRRRR+++++++
++++++++++++++RRR++++++++++++++++++++++RRR+++++++++
++++++++++++++RRR++++++++++++++++++++++++++++++++++