#mapinfo
name: Big Map
size: 70x28
lives: 10
money: 600
towers: t1, t2
path start: 1, 17

#waves 
number of waves: 2
50, e1, e2, e1, e1, e1
10, e1, e1, e2, e1, e1

#map
++++++++++++++++++++++++++++RRR+++++++++++++++++++++++++++++++++++++++
++++++++++++++++++++++++++++RRR+++++++++++++++++++++++++++++++++++++++
++++++++++++++++++++++++++++RRR+++++++++++++++++++++++++++++++++++++++
++++++++++++++++++++++++++++RRR+++++++++++++++++++++++++++++++++++++++
++++++++++++++++++++++++++++RRR+++++++++++++++++++++++++++++++++++++++
++++++++++++++++++++++++++++RRR+++++++++++++++++++++++++++++++++++++++
++++++++++++++++++++++++++++RRR+++++++++++++++++++++++++++++++++++++++
++++++++++++++++++++++++++++RRR+++++++++++++++++++++++++++++++++++++++
++++++++++++++++++++++++++++RRR+++++++++++++++++++++++++++++++++++++++
++++++++++++++++++++++++++++RRR+++++++++++++++++++++++++++++++++++++++
++++++++++++++++++++++++++++RRR+++++++++++++++++++++++++++++++++++++++
++++++++++++++++++++++++++++RRR+++++++++++++++++++++++++++++++++++++++
++++++++++++++++++++++++++++RRR+++++++++++++++++++++++++++++++++++++++
0000000000000000000000000000000000000000000000000000000000000000000000
PPPPPPPPPPPPPPPPPPPPPPPPPPPPPPPPPPPPPPPPPPPPPPPPPPPPPPPPPPPPPPPPPPPPPP
0000000000000000000000000000000000000000000000000000000000000000000000
++++++++++++++++++++++++++++RRR+++++++++++++++++++++++++++++++++++++++
++++++++++++++++++++++++++++RRR+++++++++++++++++++++++++++++++++++++++
++++++++++++++++++++++++++++RRR+++++++++++++++++++++++++++++++++++++++
++++++++++++++++++++++++++++RRR+++++++++++++++++++++++++++++++++++++++
++++++++++++++++++++++++++++RRR+++++++++++++++++++++++++++++++++++++++
++++++++++++++++++++++++++++RRR+++++++++++++++++++++++++++++++++++++++
++++++++++++++++++++++++++++RRR+++++++++++++++++++++++++++++++++++++++
++++++++++++++++++++++++++++RRR+++++++++++++++++++++++++++++++++++++++
++++++++++++++++++++++++++++RRR+++++++++++++++++++++++++++++++++++++++
++++++++++++++++++++++++++++RRR+++++++++++++++++++++++++++++++++++++++
++++++++++++++++++++++++++++RRR+++++++++++++++++++++++++++++++++++++++
++++++++++++++++++++++++++++RRR+++++++++++++++++++++++++++++++++++++++