#mapinfo
name: Big Map
size: 70x28
lives: 10
money: 600
towers: t1, t2
path start: 1, 20

#waves 
number of waves: 2
50, e1, e2, e1, e1, e1
10, e1, e1, e2, e1, e1

#map
++++++++++++++++++++++++++++++++++++++++++++++++++++++++++++++++++++++
++++++++++++++++++++++++++++++++++++000000000000000000++++++++++++++++
++++++++++++++++++++++++++++++++00000000000000000000000000++++++++++++
++++++++CC++CC+++++++++++++++++0000000000000000000000000000+++++++++++
++++++++CC++CC+++++++++++++++++0000000000000000000000000000+++++++++++
+++++++++++++++++++++++++++++++++WWWWWWWWWWWWWWWWWWWWWWWW+++++++++++++
+++++++++CCCC++++++++++++++++++++WWWWWWWWWWWWWWWWWWWWWWWW+++++++++++++
++++++++C++++C+++++++++++++++++0000000+++++++++++0000000000+++++++++++
++++++++C++++C+++++++++++++++++000000000+++++++000000000000+++++++++++
++++++++C++++C+++++++++++++++++++WWWWWWWWW+++WWWWWWWWWWW++++++++++++++
++++++++C++++C+++++++++++++++++++WWWWWWWWWWWWWWWWWWWWWWW++++++++++++++
+++++++++CCCC++++++++++++++++++000000000000P000000000000000+++++++++++
++++++++++++++++++++++++++++++++00000000000P00000000000000++++++++++++
+++++++++++++++++++++++++++++MMMMMMMMMMMMMMXMMMMMMMMMMMMMMMMM+++++++++
++++++++++++++++++++++++++++++MMMMMMMMMMMMMXMMMMMMMMMMMMMMMM++++++++++
++++++++++++++++++++++++++++++++++++++++++0P0+++++++++++++++++++++++++
++++++++++++++++++++++++++++++++++++++++++0P0+++++++++++++++++++++++++
++++++++++++++++++++++++++++++++++++++++++0P0+++++++++++++++++++++++++
0000000000000000000000000000000000000000000P0+++++++++++++++++++++++++
PPPPPPPPPPPPPPPPPPPPPPPPPPPPPPPPPPPPPPPPPPPP0+++++++++CC+++CC+++++++++
000000000000000000000000000000000000000000000+++++++++CC+++CC+++++++++
++++++++++++++++++++++++++++++++++++++++++++++++++++++++++++++++++++++
++++++++++++++++++++++++++++++++++++++++++++++++++++CCCCCCCCCCC+++++++
++++++++++++++++++++++++++++++++++++++++++++++++++++++++++C+++C+++++++
++++++++++++++++++++++++++++++++++++++++++++++++++++++++++C+++C+++++++
+++++++++++++++++++++++++++++++++++++++++++++++++++++++++++CCC++++++++
++++++++++++++++++++++++++++++++++++++++++++++++++++++++++++++++++++++
++++++++++++++++++++++++++++++++++++++++++++++++++++++++++++++++++++++